##########
#P.......#
#.######.#
#........#
####.#####
####.#####
#........#
####NT####
##########